ئ	hamfist,hamextfingeril,hampalmr,hamshoulders
ا	hamfinger2345,hamthumboutmod,hamextfingeril,hampalmdr,hamshoulders
ب	hamflathand,hamextfingeril,hampalmdr,hamtongue
پ	hamflathand,hamthumbacrossmod,hampinky,hamfingerhookmod,hamextfingeru,hampalmu,hamneck
ت	hamflathand,hamextfingeru,hampalmu,hamchin
ج	hamfist,hamthumbacrossmod,hamextfingerui,hamextfingeril,hampalmdr,hamcheek,hamlrat
چ	hamfist,hamextfingerui,hamextfingeril,hampalmdr,hamcheek,hamlrat 
‌‌ح	hamflathand,hamextfingerdo,hampalmu,hamchest,hamparbegin,hammoveu,hamreplace,hamextfingeru,hamparend,hamunderchin
خ	hamfinger2,hamextfingerl,hampalml,hamunderchin
د	hamcee12,hamextfingeru,hampalml,hamchin
ر	hamfinger2,hamextfingerl,hampalml,hamteeth,hamswinging,hamslow
ڕ	hamfinger2,hamextfingerl,hampalml,hamteeth,hamswinging,hamparbegin,hamreplace,hamfinger2,hamthumboutmod,hamparend,hamear
ز	hamfinger2,hamextfingeru,hampalmu,hamlips,hammoveo,hamarcu
ژ	hamflathand,hamfingerbendmod,hamextfingeru,hampalmu,hamunderchin,hammoved,hamarcu
س	hamfist,hamextfingerl,hampalmr,hamlips
ش	hamfist,hamextfingerl,hampalmr,hamlips,hammovel 
ع	hamfinger2,hamextfingerui,hamextfingeril,hampalmd,hamneck
غ	hamfinger2,hamextfingerui,hamextfingeril,hampalmd,hamneck,hamnodding,hamslow
ف	hamfinger2,hamextfingeru,hampalmu,hamteeth
ڤ	hamfinger2,hamextfingeru,hampalmu,hamunderchin,hammover,hammovel,hammovel,hammover 
ق	hamfinger23,hamextfingeru,hampalmu,hamlips 
ک	hamfinger2,hamextfingeru,hampalmu,hamteeth
گ	hamfinger23,hamextfingerui,hamextfingeril,hampalmdr,hamunderchin,hamlrbeside
ل	hamfinger2,hamthumboutmod,hamextfingeru,hampalmd,hamear
ڵ	hamfinger2,hamthumboutmod,hamextfingeru,hampalmd,hamear,hamparbegin,hammover,hamreplace,hampalmu,hamparend
م	hamfinger2,hamextfingeru,hampalml,hamlips,hamlrat 
ن	hamfinger2,hamextfingerui,hamextfingeril,hampalmdr,hamnostrils
ۆ	hamfinger2,hamextfingeru,hampalmu,hamlrbeside,hamtongue,hamcircleo,hamsmallmod,hamrepeatfromstart,hamparbegin,hammover,hamreplace,hamfinger2,hamthumboutmod,hamparend
و	hamfinger2,hamextfingeru,hampalmu,hamlrbeside,hamtongue,hamcircleo,hamsmallmod,hamrepeatfromstart
وو	hamfinger23,hamextfingeru,hampalmu,hamlrbeside,hamtongue,hamcircleo,hamsmallmod,hamrepeatfromstart 
ه	hamflathand,hamextfingeru,hampalmu,hamunderchin,hammoveo
ە	hamflathand,hamextfingeru,hampalmu,hamneck 
ێ	hamcee12,hamextfingerl,hampalmu,hamunderchin,hamparbegin,hammover,hamreplace,hamextfingeru,hampalmu,hamparend,hamparbegin,hamreplace,hamfinger2,hamthumboutmod,hamparend
ی	hamcee12,hamextfingerl,hampalmu,hamunderchin 
